00000000000000000000000000000
01111111111100000111111111110
01000100000100000100000100010
01000100000100000100000100010
01111111111111111111111111110
01000100100000000000100100010
01111100111110001111100111110
01000100000010001000000100010
01000100111111111111100100010
11111100100000000000100111111
01000100100000000000100100010
01000100111111111111100100010
01000100000010001000000100010
01111100111110001111100111110
01000100100000000000100100010
01000111111111111111111100010
01000100001000000001000100010
01000100001111P11111000100010
01111111111000000001111111110
00000000000000000000000000000