00000000000000000000000000000
0C111C11111C00000C11111C111C0
01000100000100000100000100010
01000100000100000100000100010
0C111C11C11C1111GC11C11C111C0
01000100100000000000100100010
0C111C00C1G1C000C1G1C00C111C0
01000100000010001000000100010
01000100C111C111C111C00100010
9C111C00100000000000100C111C9
01000100100000000000100100010
01000100C111C111C111C00100010
01000100000010001000000100010
0C111C00C111C000C111C00C111C0
01000100100000000000100100010
01000C11C1C11111111CC11C000C0
01000G00001000000001000100010
0100010000C111P1111C000100010
0C111C1111C00000000C111C111C0
00000000000000000000000000000